8 8 8 8 8 8 8 8 8 8 8 8 8 8 8 8 8
8 0 10 20 5 0 11 21 5 12 0 22 13 0 8 8 8
8 4 3 0 5 0 0 0 3 0 3 0 3 0 8 8 8
8 4 3 0 4 4 4 0 3 0 3 5 3 0 8 8 8
8 4 0 0 3 0 0 3 3 0 5 0 0 7 8 8 8
8 4 0 0 3 0 3 5 0 0 3 4 3 5 8 8 8
8 4 4 0 0 0 3 0 0 5 3 4 3 5 8 8 8
8 0 0 0 0 0 4 4 5 3 0 4 0 0 8 8 8
8 0 0 0 5 4 3 0 3 0 3 0 3 0 8 8 8
8 5 3 6 5 0 3 0 3 0 6 6 3 6 8 8 8 
8 6 3 0 3 0 3 3 3 0 3 5 3 6 8 9 8
8 4 3 0 3 0 0 0 0 0 0 0 0 6 8 8 8 
8 6 3 0 0 0 0 3 3 3 0 0 3 6 8 8 8
8 6 3 0 0 2 0 3 1 3 0 3 3 3 8 8 8
8 8 8 8 8 8 8 8 8 8 8 8 8 8 8 8 8
8 8 8 8 8 8 8 8 8 8 8 8 8 8 8 8 8
8 8 8 8 8 8 8 8 8 8 8 8 8 8 8 8 8


